###############
#P-----.-----.#
#-##-#-#-#-##-#
#-----.-.-----#
#-##-------##-#
#.-----G-----.#
#-##--#X#--##-#
#.----#X#----.#
#-##--###--##-#
#-----.-.-----#
#-##-------##-#
#-----.-.-----#
#-##-#---#-##-#
#.-----S-----P#
###############